
camera controls
w = translate forward
s = translate backward
a = translate left
d = translate right
q = translate upward
e = translate downward
W = rotate downward
S = rotate upward
A = rotate left
D = rotate right
Q = rotate counterclockwise
E = rotate clockwise

Escape = reset view
, = toggle perspective On
= toggle perspective Off
b = Blinn-Phong on, Light map on
m = Blinn-Phong off, Light map on
u = Blinn-Phong and Light Map off

Left Arrow Key = select previous model
right arrow key - select next model
spacebar = deselect model

while a model is selected,
k = translate left
; = translate right
l = translate back
o = translate forward
i = translate up
p = translate down

K = rotate left 
: = rotate right
L = rotate up
O = rotate down
I = rotate counterclockwise
P = rotate clockwise

backspace = reset model position

n = adjust luminosity
numpad1 = adjust model's ambient lighting
numpad2 = adjust model's diffuse lighting
numpad3 = adjust model's specular lighting

